10 10
21 32 19 63 14 49 77 33 38 57
13 56 74 58 83 96 86 6 65 71
27 55 59 43 53 45 50 72 52 5
81 37 36 29 31 100 70 20 84 60
44 39 69 16 79 66 73 88 7 17
99 11 1 64 25 23 24 62 12 54
98 18 95 26 10 75 93 61 94 51
40 97 92 47 90 9 28 46 80 2
22 3 35 30 41 67 76 4 87 89
91 34 48 15 82 42 68 85 78 8